{
{' ', '#', '#', '#', '#', '#', '#', '#', '#', '#', '#', '#', '#', '#', '#', '#', '#', '#', '#', '#', '#', '#', '#', '#', '#', '#', '#', '#', '#', '#', '#', '#', '#', '#', '#', '#', '#', '#', '#', '#', '#', '#', '#', '#', '#', '#', '#', '#', '#', '#', '#', '#', '#', '#', '#', '#', '#', '#', '#', '#', '#', '#', '#', '#', '#', '#', '#', '#', '#', '#', '#', '#', '#', '#', '#', '#', '#', '#', '#', '#', '#', '#', '#', '#', '#', '#', '#', '#', '#', '#', '#', '#', '#', '#', '#', '#', '#', '#', '#', '#', '#'},
{' ', ' ', ' ', ' ', ' ', ' ', ' ', ' ', ' ', ' ', ' ', ' ', ' ', ' ', ' ', ' ', ' ', ' ', ' ', ' ', ' ', ' ', ' ', ' ', ' ', ' ', ' ', ' ', ' ', ' ', ' ', ' ', ' ', ' ', ' ', ' ', ' ', ' ', ' ', ' ', ' ', ' ', ' ', ' ', ' ', ' ', ' ', ' ', ' ', ' ', ' ', ' ', '#', ' ', ' ', ' ', ' ', ' ', ' ', ' ', ' ', ' ', ' ', ' ', ' ', ' ', ' ', ' ', ' ', ' ', ' ', ' ', ' ', ' ', ' ', ' ', ' ', ' ', ' ', ' ', ' ', ' ', ' ', ' ', ' ', ' ', ' ', ' ', ' ', ' ', ' ', ' ', ' ', ' ', ' ', ' ', ' ', ' ', ' ', ' ', '#'},
{'#', ' ', '#', '#', '#', '#', '#', '#', '#', ' ', '#', '#', '#', '#', '#', '#', '#', ' ', '#', '#', '#', ' ', '#', '#', '#', '#', '#', ' ', '#', '#', '#', '#', '#', '#', '#', '#', '#', '#', '#', '#', '#', ' ', '#', '#', '#', '#', '#', '#', '#', '#', '#', ' ', '#', '#', '#', '#', '#', '#', '#', '#', '#', '#', '#', '#', '#', '#', '#', '#', '#', '#', '#', '#', '#', '#', '#', ' ', '#', '#', '#', '#', '#', '#', '#', '#', '#', '#', '#', '#', '#', '#', '#', ' ', '#', '#', '#', ' ', '#', '#', '#', ' ', '#'},
{'#', ' ', ' ', ' ', '#', ' ', ' ', ' ', '#', ' ', '#', ' ', ' ', ' ', ' ', ' ', '#', ' ', '#', ' ', '#', ' ', '#', ' ', ' ', ' ', '#', ' ', '#', ' ', ' ', ' ', ' ', ' ', '#', ' ', ' ', ' ', ' ', ' ', '#', ' ', ' ', ' ', ' ', ' ', ' ', ' ', ' ', ' ', '#', ' ', ' ', ' ', ' ', ' ', ' ', ' ', ' ', ' ', ' ', ' ', ' ', ' ', ' ', ' ', ' ', ' ', ' ', ' ', ' ', ' ', ' ', ' ', '#', ' ', '#', ' ', ' ', ' ', ' ', ' ', ' ', ' ', ' ', ' ', ' ', ' ', '#', ' ', ' ', ' ', '#', ' ', ' ', ' ', '#', ' ', '#', ' ', '#'},
{'#', ' ', '#', '#', '#', ' ', '#', '#', '#', '#', '#', ' ', '#', '#', '#', ' ', '#', ' ', '#', ' ', '#', ' ', '#', '#', '#', ' ', '#', ' ', '#', '#', '#', ' ', '#', '#', '#', ' ', '#', '#', '#', ' ', '#', '#', '#', ' ', '#', '#', '#', '#', '#', ' ', '#', ' ', '#', '#', '#', '#', '#', '#', '#', '#', '#', '#', '#', '#', '#', '#', '#', '#', '#', ' ', '#', '#', '#', ' ', '#', '#', '#', ' ', '#', '#', '#', '#', '#', '#', '#', ' ', '#', '#', '#', ' ', '#', '#', '#', ' ', '#', '#', '#', ' ', '#', ' ', '#'},
{'#', ' ', '#', ' ', ' ', ' ', '#', ' ', ' ', ' ', ' ', ' ', ' ', ' ', '#', ' ', '#', ' ', '#', ' ', '#', ' ', ' ', ' ', '#', ' ', '#', ' ', ' ', ' ', ' ', ' ', '#', ' ', ' ', ' ', '#', ' ', '#', ' ', '#', ' ', '#', ' ', '#', ' ', ' ', ' ', '#', ' ', '#', ' ', '#', ' ', ' ', ' ', ' ', ' ', ' ', ' ', ' ', ' ', ' ', ' ', ' ', ' ', ' ', ' ', '#', ' ', '#', ' ', '#', ' ', ' ', ' ', ' ', ' ', '#', ' ', ' ', ' ', '#', ' ', '#', ' ', '#', ' ', ' ', ' ', '#', ' ', ' ', ' ', '#', ' ', ' ', ' ', '#', ' ', '#'},
{'#', ' ', '#', '#', '#', ' ', '#', ' ', '#', '#', '#', '#', '#', ' ', '#', ' ', '#', '#', '#', ' ', '#', '#', '#', ' ', '#', ' ', '#', ' ', '#', '#', '#', '#', '#', ' ', '#', '#', '#', ' ', '#', ' ', '#', ' ', '#', ' ', '#', ' ', '#', ' ', '#', ' ', '#', '#', '#', ' ', '#', '#', '#', ' ', '#', ' ', '#', '#', '#', '#', '#', ' ', '#', '#', '#', ' ', '#', ' ', '#', ' ', '#', '#', '#', ' ', '#', '#', '#', ' ', '#', ' ', '#', '#', '#', '#', '#', ' ', '#', '#', '#', ' ', '#', ' ', '#', '#', '#', ' ', '#'},
{'#', ' ', '#', ' ', '#', ' ', ' ', ' ', '#', ' ', ' ', ' ', '#', ' ', '#', ' ', ' ', ' ', ' ', ' ', ' ', ' ', '#', ' ', ' ', ' ', ' ', ' ', '#', ' ', ' ', ' ', ' ', ' ', '#', ' ', ' ', ' ', '#', ' ', ' ', ' ', '#', ' ', '#', ' ', '#', ' ', '#', ' ', ' ', ' ', ' ', ' ', '#', ' ', '#', ' ', '#', ' ', '#', ' ', ' ', ' ', '#', ' ', '#', ' ', ' ', ' ', ' ', ' ', '#', ' ', '#', ' ', '#', ' ', ' ', ' ', ' ', ' ', '#', ' ', ' ', ' ', ' ', ' ', ' ', ' ', ' ', ' ', ' ', ' ', '#', ' ', ' ', ' ', ' ', ' ', '#'},
{'#', ' ', '#', ' ', '#', '#', '#', ' ', '#', ' ', '#', ' ', '#', ' ', '#', ' ', '#', '#', '#', '#', '#', '#', '#', ' ', '#', '#', '#', ' ', '#', ' ', '#', '#', '#', ' ', '#', ' ', '#', '#', '#', ' ', '#', '#', '#', ' ', '#', '#', '#', ' ', '#', '#', '#', '#', '#', ' ', '#', ' ', '#', '#', '#', ' ', '#', ' ', '#', '#', '#', ' ', '#', ' ', '#', ' ', '#', '#', '#', ' ', '#', ' ', '#', ' ', '#', '#', '#', ' ', '#', '#', '#', ' ', '#', '#', '#', '#', '#', '#', '#', ' ', '#', '#', '#', '#', '#', ' ', '#'},
{'#', ' ', ' ', ' ', ' ', ' ', '#', ' ', '#', ' ', '#', ' ', '#', ' ', ' ', ' ', '#', ' ', ' ', ' ', ' ', ' ', ' ', ' ', '#', ' ', '#', ' ', '#', ' ', '#', ' ', '#', ' ', '#', ' ', ' ', ' ', '#', ' ', '#', ' ', ' ', ' ', ' ', ' ', ' ', ' ', ' ', ' ', ' ', ' ', '#', ' ', ' ', ' ', ' ', ' ', ' ', ' ', '#', ' ', '#', ' ', '#', ' ', '#', ' ', '#', ' ', '#', ' ', '#', ' ', '#', ' ', '#', ' ', '#', ' ', ' ', ' ', ' ', ' ', '#', ' ', '#', ' ', ' ', ' ', ' ', ' ', '#', ' ', ' ', ' ', '#', ' ', '#', ' ', '#'},
{'#', ' ', '#', '#', '#', '#', '#', ' ', '#', ' ', '#', '#', '#', '#', '#', '#', '#', ' ', '#', '#', '#', '#', '#', '#', '#', ' ', '#', ' ', '#', ' ', '#', ' ', '#', ' ', '#', '#', '#', ' ', '#', '#', '#', ' ', '#', '#', '#', '#', '#', ' ', '#', '#', '#', ' ', '#', '#', '#', ' ', '#', ' ', '#', '#', '#', ' ', '#', ' ', '#', ' ', '#', ' ', '#', ' ', '#', ' ', '#', ' ', '#', ' ', '#', ' ', '#', '#', '#', ' ', '#', ' ', '#', '#', '#', ' ', '#', '#', '#', ' ', '#', '#', '#', '#', '#', ' ', '#', ' ', '#'},
{'#', ' ', '#', ' ', ' ', ' ', ' ', ' ', '#', ' ', '#', ' ', ' ', ' ', ' ', ' ', ' ', ' ', '#', ' ', '#', ' ', ' ', ' ', ' ', ' ', '#', ' ', '#', ' ', '#', ' ', '#', ' ', ' ', ' ', '#', ' ', ' ', ' ', ' ', ' ', '#', ' ', ' ', ' ', '#', ' ', '#', ' ', ' ', ' ', ' ', ' ', '#', ' ', '#', ' ', '#', ' ', ' ', ' ', '#', ' ', '#', ' ', '#', ' ', ' ', ' ', '#', ' ', ' ', ' ', '#', ' ', '#', ' ', ' ', ' ', '#', ' ', '#', ' ', ' ', ' ', ' ', ' ', '#', ' ', '#', ' ', ' ', ' ', ' ', ' ', ' ', ' ', '#', ' ', '#'},
{'#', ' ', '#', ' ', '#', '#', '#', '#', '#', ' ', '#', ' ', '#', '#', '#', '#', '#', '#', '#', ' ', '#', '#', '#', '#', '#', ' ', '#', '#', '#', ' ', '#', ' ', '#', ' ', '#', ' ', '#', '#', '#', ' ', '#', '#', '#', ' ', '#', ' ', '#', '#', '#', ' ', '#', '#', '#', ' ', '#', ' ', '#', ' ', '#', '#', '#', ' ', '#', ' ', '#', ' ', '#', '#', '#', '#', '#', ' ', '#', '#', '#', ' ', '#', '#', '#', ' ', '#', '#', '#', '#', '#', ' ', '#', '#', '#', ' ', '#', ' ', '#', '#', '#', '#', '#', ' ', '#', ' ', '#'},
{'#', ' ', '#', ' ', '#', ' ', ' ', ' ', ' ', ' ', '#', ' ', '#', ' ', ' ', ' ', ' ', ' ', ' ', ' ', ' ', ' ', ' ', ' ', ' ', ' ', ' ', ' ', ' ', ' ', ' ', ' ', '#', ' ', '#', ' ', ' ', ' ', ' ', ' ', '#', ' ', ' ', ' ', ' ', ' ', ' ', ' ', '#', ' ', '#', ' ', ' ', ' ', '#', ' ', '#', ' ', ' ', ' ', '#', ' ', '#', ' ', ' ', ' ', ' ', ' ', ' ', ' ', ' ', ' ', '#', ' ', ' ', ' ', ' ', ' ', '#', ' ', ' ', ' ', ' ', ' ', '#', ' ', '#', ' ', ' ', ' ', '#', ' ', '#', ' ', ' ', ' ', '#', ' ', '#', ' ', '#'},
{'#', ' ', '#', ' ', '#', ' ', '#', '#', '#', ' ', '#', ' ', '#', ' ', '#', '#', '#', '#', '#', '#', '#', ' ', '#', '#', '#', ' ', '#', '#', '#', ' ', '#', '#', '#', '#', '#', '#', '#', ' ', '#', '#', '#', ' ', '#', '#', '#', ' ', '#', '#', '#', ' ', '#', '#', '#', ' ', '#', ' ', '#', ' ', '#', '#', '#', ' ', '#', ' ', '#', '#', '#', '#', '#', ' ', '#', ' ', '#', '#', '#', ' ', '#', '#', '#', ' ', '#', '#', '#', '#', '#', ' ', '#', ' ', '#', ' ', '#', ' ', '#', ' ', '#', '#', '#', '#', '#', ' ', '#'},
{'#', ' ', '#', ' ', ' ', ' ', '#', ' ', '#', ' ', ' ', ' ', '#', ' ', '#', ' ', ' ', ' ', ' ', ' ', '#', ' ', '#', ' ', '#', ' ', '#', ' ', ' ', ' ', '#', ' ', ' ', ' ', ' ', ' ', '#', ' ', '#', ' ', ' ', ' ', '#', ' ', '#', ' ', '#', ' ', '#', ' ', ' ', ' ', ' ', ' ', '#', ' ', '#', ' ', ' ', ' ', '#', ' ', '#', ' ', ' ', ' ', ' ', ' ', '#', ' ', '#', ' ', ' ', ' ', ' ', ' ', '#', ' ', ' ', ' ', '#', ' ', ' ', ' ', ' ', ' ', '#', ' ', '#', ' ', '#', ' ', ' ', ' ', '#', ' ', ' ', ' ', ' ', ' ', '#'},
{'#', ' ', '#', '#', '#', ' ', '#', ' ', '#', '#', '#', ' ', '#', ' ', '#', '#', '#', ' ', '#', '#', '#', '#', '#', ' ', '#', '#', '#', ' ', '#', '#', '#', ' ', '#', '#', '#', '#', '#', ' ', '#', ' ', '#', ' ', '#', ' ', '#', ' ', '#', ' ', '#', '#', '#', '#', '#', ' ', '#', ' ', '#', '#', '#', '#', '#', ' ', '#', '#', '#', ' ', '#', '#', '#', ' ', '#', ' ', '#', '#', '#', '#', '#', ' ', '#', '#', '#', '#', '#', ' ', '#', '#', '#', ' ', '#', '#', '#', ' ', '#', '#', '#', ' ', '#', '#', '#', ' ', '#'},
{'#', ' ', ' ', ' ', '#', ' ', '#', ' ', ' ', ' ', '#', ' ', '#', ' ', ' ', ' ', '#', ' ', '#', ' ', ' ', ' ', ' ', ' ', ' ', ' ', '#', ' ', '#', ' ', ' ', ' ', ' ', ' ', ' ', ' ', ' ', ' ', '#', ' ', '#', ' ', '#', ' ', '#', ' ', ' ', ' ', ' ', ' ', ' ', ' ', '#', ' ', '#', ' ', ' ', ' ', ' ', ' ', ' ', ' ', '#', ' ', '#', ' ', '#', ' ', ' ', ' ', '#', ' ', '#', ' ', ' ', ' ', ' ', ' ', ' ', ' ', ' ', ' ', '#', ' ', '#', ' ', ' ', ' ', ' ', ' ', ' ', ' ', '#', ' ', ' ', ' ', '#', ' ', '#', ' ', '#'},
{'#', ' ', '#', '#', '#', ' ', '#', '#', '#', ' ', '#', '#', '#', ' ', '#', '#', '#', ' ', '#', ' ', '#', '#', '#', ' ', '#', '#', '#', ' ', '#', ' ', '#', '#', '#', '#', '#', '#', '#', ' ', '#', '#', '#', '#', '#', ' ', '#', ' ', '#', ' ', '#', '#', '#', ' ', '#', ' ', '#', ' ', '#', ' ', '#', '#', '#', ' ', '#', ' ', '#', ' ', '#', '#', '#', '#', '#', ' ', '#', '#', '#', ' ', '#', '#', '#', '#', '#', ' ', '#', ' ', '#', '#', '#', ' ', '#', '#', '#', ' ', '#', '#', '#', '#', '#', ' ', '#', ' ', '#'},
{'#', ' ', '#', ' ', ' ', ' ', ' ', ' ', '#', ' ', ' ', ' ', ' ', ' ', '#', ' ', ' ', ' ', '#', ' ', '#', ' ', ' ', ' ', '#', ' ', ' ', ' ', ' ', ' ', '#', ' ', ' ', ' ', ' ', ' ', '#', ' ', ' ', ' ', ' ', ' ', ' ', ' ', '#', ' ', '#', ' ', ' ', ' ', '#', ' ', '#', ' ', '#', ' ', '#', ' ', '#', ' ', '#', ' ', ' ', ' ', '#', ' ', ' ', ' ', ' ', ' ', ' ', ' ', ' ', ' ', '#', ' ', '#', ' ', '#', ' ', ' ', ' ', '#', ' ', ' ', ' ', '#', ' ', ' ', ' ', '#', ' ', ' ', ' ', ' ', ' ', ' ', ' ', '#', ' ', '#'},
{'#', ' ', '#', '#', '#', '#', '#', ' ', '#', ' ', '#', '#', '#', '#', '#', ' ', '#', '#', '#', ' ', '#', '#', '#', ' ', '#', '#', '#', ' ', '#', '#', '#', ' ', '#', '#', '#', ' ', '#', '#', '#', '#', '#', '#', '#', '#', '#', ' ', '#', '#', '#', '#', '#', ' ', '#', '#', '#', ' ', '#', '#', '#', ' ', '#', ' ', '#', '#', '#', ' ', '#', '#', '#', '#', '#', '#', '#', ' ', '#', '#', '#', ' ', '#', '#', '#', '#', '#', ' ', '#', ' ', '#', '#', '#', '#', '#', ' ', '#', '#', '#', '#', '#', ' ', '#', ' ', '#'},
{'#', ' ', ' ', ' ', ' ', ' ', '#', ' ', ' ', ' ', '#', ' ', ' ', ' ', ' ', ' ', ' ', ' ', ' ', ' ', '#', ' ', ' ', ' ', ' ', ' ', '#', ' ', '#', ' ', ' ', ' ', '#', ' ', '#', ' ', ' ', ' ', '#', ' ', ' ', ' ', ' ', ' ', '#', ' ', ' ', ' ', ' ', ' ', ' ', ' ', ' ', ' ', ' ', ' ', ' ', ' ', ' ', ' ', '#', ' ', '#', ' ', ' ', ' ', '#', ' ', ' ', ' ', ' ', ' ', '#', ' ', ' ', ' ', ' ', ' ', ' ', ' ', ' ', ' ', ' ', ' ', '#', ' ', ' ', ' ', '#', ' ', ' ', ' ', '#', ' ', '#', ' ', '#', ' ', '#', ' ', '#'},
{'#', ' ', '#', '#', '#', ' ', '#', '#', '#', '#', '#', ' ', '#', '#', '#', '#', '#', '#', '#', '#', '#', ' ', '#', '#', '#', ' ', '#', '#', '#', ' ', '#', '#', '#', ' ', '#', '#', '#', '#', '#', '#', '#', '#', '#', ' ', '#', '#', '#', '#', '#', '#', '#', '#', '#', '#', '#', ' ', '#', '#', '#', '#', '#', '#', '#', ' ', '#', ' ', '#', '#', '#', '#', '#', ' ', '#', '#', '#', '#', '#', '#', '#', '#', '#', '#', '#', ' ', '#', '#', '#', ' ', '#', '#', '#', '#', '#', ' ', '#', ' ', '#', '#', '#', ' ', '#'},
{'#', ' ', '#', ' ', ' ', ' ', ' ', ' ', ' ', ' ', ' ', ' ', ' ', ' ', ' ', ' ', ' ', ' ', ' ', ' ', ' ', ' ', ' ', ' ', ' ', ' ', ' ', ' ', ' ', ' ', ' ', ' ', ' ', ' ', ' ', ' ', ' ', ' ', ' ', ' ', ' ', ' ', ' ', ' ', ' ', ' ', ' ', ' ', ' ', ' ', ' ', ' ', ' ', ' ', ' ', ' ', ' ', ' ', ' ', ' ', ' ', ' ', ' ', ' ', ' ', ' ', ' ', ' ', ' ', ' ', ' ', ' ', ' ', ' ', ' ', ' ', ' ', ' ', ' ', ' ', '#', ' ', ' ', ' ', ' ', ' ', ' ', ' ', ' ', ' ', ' ', ' ', ' ', ' ', ' ', ' ', ' ', ' ', ' ', ' ', ' '},
{'#', '#', '#', '#', '#', '#', '#', '#', '#', '#', '#', '#', '#', '#', '#', '#', '#', '#', '#', '#', '#', '#', '#', '#', '#', '#', '#', '#', '#', '#', '#', '#', '#', '#', '#', '#', '#', '#', '#', '#', '#', '#', '#', '#', '#', '#', '#', '#', '#', '#', '#', '#', '#', '#', '#', '#', '#', '#', '#', '#', '#', '#', '#', '#', '#', '#', '#', '#', '#', '#', '#', '#', '#', '#', '#', '#', '#', '#', '#', '#', '#', '#', '#', '#', '#', '#', '#', '#', '#', '#', '#', '#', '#', '#', '#', '#', '#', '#', '#', '#', '#'}
}
