{
{' ', '#', '#', '#', '#', '#', '#', '#', '#', '#', '#', '#', '#', '#', '#', '#', '#', '#', '#', '#', '#', '#', '#', '#', '#', '#', '#', '#', '#', '#', '#', '#', '#', '#', '#', '#', '#', '#', '#', '#', '#', '#', '#', '#', '#', '#', '#', '#', '#', '#', '#', '#', '#', '#', '#', '#', '#', '#', '#', '#', '#', '#', '#', '#', '#', '#', '#', '#', '#', '#', '#', '#', '#', '#', '#', '#', '#', '#', '#', '#', '#', '#', '#', '#', '#', '#', '#', '#', '#', '#', '#', '#', '#', '#', '#', '#', '#', '#', '#', '#', '#'},
{' ', ' ', ' ', ' ', ' ', ' ', ' ', ' ', ' ', ' ', ' ', ' ', '#', ' ', ' ', ' ', ' ', ' ', ' ', ' ', ' ', ' ', ' ', ' ', ' ', ' ', ' ', ' ', ' ', ' ', ' ', ' ', ' ', ' ', ' ', ' ', ' ', ' ', ' ', ' ', ' ', ' ', ' ', ' ', ' ', ' ', ' ', ' ', ' ', ' ', ' ', ' ', ' ', ' ', ' ', ' ', ' ', ' ', '#', ' ', ' ', ' ', ' ', ' ', ' ', ' ', ' ', ' ', ' ', ' ', ' ', ' ', ' ', ' ', ' ', ' ', ' ', ' ', ' ', ' ', ' ', ' ', ' ', ' ', ' ', ' ', ' ', ' ', ' ', ' ', ' ', ' ', ' ', ' ', ' ', ' ', ' ', ' ', ' ', ' ', '#'},
{'#', ' ', '#', '#', '#', '#', '#', '#', '#', '#', '#', '#', '#', ' ', '#', ' ', '#', '#', '#', '#', '#', '#', '#', '#', '#', '#', '#', '#', '#', '#', '#', '#', '#', '#', '#', ' ', '#', '#', '#', ' ', '#', '#', '#', '#', '#', ' ', '#', '#', '#', ' ', '#', ' ', '#', '#', '#', '#', '#', ' ', '#', '#', '#', '#', '#', ' ', '#', '#', '#', ' ', '#', '#', '#', '#', '#', '#', '#', '#', '#', '#', '#', ' ', '#', '#', '#', '#', '#', '#', '#', '#', '#', '#', '#', '#', '#', ' ', '#', '#', '#', '#', '#', ' ', '#'},
{'#', ' ', ' ', ' ', ' ', ' ', ' ', ' ', ' ', ' ', ' ', ' ', ' ', ' ', ' ', ' ', '#', ' ', ' ', ' ', ' ', ' ', ' ', ' ', ' ', ' ', ' ', ' ', ' ', ' ', ' ', ' ', ' ', ' ', '#', ' ', '#', ' ', '#', ' ', '#', ' ', ' ', ' ', '#', ' ', '#', ' ', '#', ' ', '#', ' ', '#', ' ', ' ', ' ', '#', ' ', ' ', ' ', ' ', ' ', '#', ' ', '#', ' ', '#', ' ', '#', ' ', ' ', ' ', ' ', ' ', ' ', ' ', ' ', ' ', '#', ' ', '#', ' ', ' ', ' ', ' ', ' ', ' ', ' ', ' ', ' ', ' ', ' ', '#', ' ', '#', ' ', ' ', ' ', '#', ' ', '#'},
{'#', ' ', '#', '#', '#', '#', '#', ' ', '#', '#', '#', ' ', '#', ' ', '#', '#', '#', ' ', '#', '#', '#', '#', '#', '#', '#', '#', '#', '#', '#', '#', '#', '#', '#', '#', '#', ' ', '#', ' ', '#', ' ', '#', ' ', '#', '#', '#', '#', '#', ' ', '#', ' ', '#', ' ', '#', '#', '#', ' ', '#', '#', '#', ' ', '#', ' ', '#', ' ', '#', ' ', '#', '#', '#', ' ', '#', ' ', '#', '#', '#', '#', '#', '#', '#', ' ', '#', '#', '#', ' ', '#', ' ', '#', '#', '#', '#', '#', ' ', '#', '#', '#', ' ', '#', '#', '#', ' ', '#'},
{'#', ' ', '#', ' ', ' ', ' ', '#', ' ', '#', ' ', '#', ' ', '#', ' ', '#', ' ', ' ', ' ', '#', ' ', ' ', ' ', ' ', ' ', ' ', ' ', ' ', ' ', ' ', ' ', ' ', ' ', ' ', ' ', ' ', ' ', '#', ' ', '#', ' ', '#', ' ', ' ', ' ', ' ', ' ', ' ', ' ', '#', ' ', '#', ' ', ' ', ' ', '#', ' ', ' ', ' ', '#', ' ', '#', ' ', '#', ' ', '#', ' ', ' ', ' ', ' ', ' ', '#', ' ', '#', ' ', ' ', ' ', ' ', ' ', ' ', ' ', ' ', ' ', '#', ' ', '#', ' ', '#', ' ', ' ', ' ', '#', ' ', ' ', ' ', ' ', ' ', '#', ' ', ' ', ' ', '#'},
{'#', ' ', '#', '#', '#', ' ', '#', '#', '#', ' ', '#', ' ', '#', ' ', '#', '#', '#', ' ', '#', '#', '#', '#', '#', '#', '#', '#', '#', '#', '#', ' ', '#', '#', '#', '#', '#', '#', '#', ' ', '#', ' ', '#', '#', '#', ' ', '#', '#', '#', '#', '#', ' ', '#', ' ', '#', '#', '#', '#', '#', ' ', '#', ' ', '#', '#', '#', ' ', '#', '#', '#', '#', '#', ' ', '#', ' ', '#', '#', '#', '#', '#', ' ', '#', ' ', '#', ' ', '#', ' ', '#', ' ', '#', '#', '#', ' ', '#', '#', '#', '#', '#', ' ', '#', '#', '#', ' ', '#'},
{'#', ' ', ' ', ' ', '#', ' ', ' ', ' ', '#', ' ', '#', ' ', '#', ' ', ' ', ' ', '#', ' ', ' ', ' ', ' ', ' ', ' ', ' ', ' ', ' ', '#', ' ', '#', ' ', '#', ' ', ' ', ' ', ' ', ' ', ' ', ' ', '#', ' ', ' ', ' ', '#', ' ', '#', ' ', ' ', ' ', ' ', ' ', '#', ' ', '#', ' ', ' ', ' ', ' ', ' ', '#', ' ', ' ', ' ', ' ', ' ', ' ', ' ', ' ', ' ', '#', ' ', ' ', ' ', ' ', ' ', ' ', ' ', '#', ' ', '#', ' ', '#', ' ', '#', ' ', '#', ' ', ' ', ' ', '#', ' ', ' ', ' ', ' ', ' ', '#', ' ', ' ', ' ', '#', ' ', '#'},
{'#', ' ', '#', ' ', '#', ' ', '#', ' ', '#', ' ', '#', ' ', '#', '#', '#', ' ', '#', '#', '#', '#', '#', ' ', '#', '#', '#', ' ', '#', ' ', '#', '#', '#', ' ', '#', '#', '#', '#', '#', ' ', '#', ' ', '#', ' ', '#', ' ', '#', ' ', '#', '#', '#', ' ', '#', ' ', '#', '#', '#', ' ', '#', '#', '#', ' ', '#', '#', '#', ' ', '#', '#', '#', ' ', '#', '#', '#', '#', '#', '#', '#', ' ', '#', '#', '#', ' ', '#', ' ', '#', '#', '#', ' ', '#', '#', '#', ' ', '#', '#', '#', ' ', '#', '#', '#', '#', '#', ' ', '#'},
{'#', ' ', ' ', ' ', '#', ' ', '#', ' ', '#', ' ', '#', ' ', ' ', ' ', '#', ' ', ' ', ' ', ' ', ' ', '#', ' ', '#', ' ', '#', ' ', ' ', ' ', ' ', ' ', ' ', ' ', '#', ' ', ' ', ' ', '#', ' ', '#', ' ', '#', ' ', '#', ' ', '#', ' ', '#', ' ', '#', ' ', '#', ' ', ' ', ' ', '#', ' ', '#', ' ', ' ', ' ', '#', ' ', '#', ' ', ' ', ' ', ' ', ' ', ' ', ' ', ' ', ' ', ' ', ' ', ' ', ' ', ' ', ' ', '#', ' ', '#', ' ', ' ', ' ', ' ', ' ', '#', ' ', ' ', ' ', ' ', ' ', '#', ' ', '#', ' ', ' ', ' ', ' ', ' ', '#'},
{'#', ' ', '#', ' ', '#', ' ', '#', '#', '#', ' ', '#', '#', '#', ' ', '#', ' ', '#', '#', '#', ' ', '#', '#', '#', ' ', '#', '#', '#', '#', '#', '#', '#', ' ', '#', '#', '#', ' ', '#', ' ', '#', ' ', '#', '#', '#', ' ', '#', ' ', '#', ' ', '#', ' ', '#', ' ', '#', '#', '#', ' ', '#', ' ', '#', ' ', '#', ' ', '#', '#', '#', '#', '#', '#', '#', ' ', '#', '#', '#', '#', '#', '#', '#', '#', '#', ' ', '#', '#', '#', '#', '#', ' ', '#', ' ', '#', '#', '#', ' ', '#', '#', '#', ' ', '#', '#', '#', ' ', '#'},
{'#', ' ', '#', ' ', '#', ' ', ' ', ' ', ' ', ' ', ' ', ' ', ' ', ' ', '#', ' ', '#', ' ', ' ', ' ', ' ', ' ', ' ', ' ', ' ', ' ', ' ', ' ', ' ', ' ', '#', ' ', ' ', ' ', '#', ' ', '#', ' ', '#', ' ', ' ', ' ', ' ', ' ', '#', ' ', '#', ' ', '#', ' ', '#', ' ', '#', ' ', ' ', ' ', '#', ' ', '#', ' ', '#', ' ', ' ', ' ', ' ', ' ', ' ', ' ', '#', ' ', '#', ' ', ' ', ' ', ' ', ' ', ' ', ' ', ' ', ' ', ' ', ' ', ' ', ' ', '#', ' ', '#', ' ', '#', ' ', '#', ' ', ' ', ' ', ' ', ' ', '#', ' ', '#', ' ', '#'},
{'#', ' ', '#', ' ', '#', '#', '#', '#', '#', '#', '#', '#', '#', '#', '#', ' ', '#', '#', '#', '#', '#', '#', '#', '#', '#', '#', '#', ' ', '#', ' ', '#', ' ', '#', '#', '#', ' ', '#', ' ', '#', '#', '#', '#', '#', ' ', '#', '#', '#', ' ', '#', ' ', '#', ' ', '#', ' ', '#', '#', '#', ' ', '#', ' ', '#', ' ', '#', '#', '#', '#', '#', '#', '#', ' ', '#', ' ', '#', ' ', '#', '#', '#', '#', '#', ' ', '#', '#', '#', '#', '#', ' ', '#', '#', '#', ' ', '#', ' ', '#', '#', '#', '#', '#', ' ', '#', ' ', '#'},
{'#', ' ', '#', ' ', '#', ' ', ' ', ' ', ' ', ' ', ' ', ' ', ' ', ' ', '#', ' ', ' ', ' ', ' ', ' ', ' ', ' ', ' ', ' ', ' ', ' ', '#', ' ', '#', ' ', '#', ' ', '#', ' ', ' ', ' ', '#', ' ', ' ', ' ', ' ', ' ', '#', ' ', ' ', ' ', '#', ' ', '#', ' ', '#', ' ', '#', ' ', '#', ' ', ' ', ' ', '#', ' ', '#', ' ', '#', ' ', ' ', ' ', ' ', ' ', '#', ' ', '#', ' ', '#', ' ', '#', ' ', ' ', ' ', '#', ' ', '#', ' ', ' ', ' ', ' ', ' ', ' ', ' ', ' ', ' ', '#', ' ', '#', ' ', ' ', ' ', ' ', ' ', '#', ' ', '#'},
{'#', ' ', '#', ' ', '#', '#', '#', ' ', '#', '#', '#', ' ', '#', '#', '#', ' ', '#', ' ', '#', '#', '#', '#', '#', '#', '#', '#', '#', ' ', '#', ' ', '#', ' ', '#', '#', '#', ' ', '#', ' ', '#', '#', '#', '#', '#', ' ', '#', '#', '#', ' ', '#', ' ', '#', ' ', '#', ' ', '#', '#', '#', ' ', '#', ' ', '#', ' ', '#', '#', '#', '#', '#', ' ', '#', '#', '#', ' ', '#', ' ', '#', '#', '#', ' ', '#', '#', '#', ' ', '#', '#', '#', '#', '#', '#', '#', ' ', '#', ' ', '#', ' ', '#', ' ', '#', '#', '#', ' ', '#'},
{'#', ' ', '#', ' ', ' ', ' ', '#', ' ', '#', ' ', ' ', ' ', '#', ' ', ' ', ' ', '#', ' ', '#', ' ', ' ', ' ', ' ', ' ', ' ', ' ', ' ', ' ', '#', ' ', '#', ' ', ' ', ' ', ' ', ' ', '#', ' ', '#', ' ', ' ', ' ', ' ', ' ', ' ', ' ', ' ', ' ', '#', ' ', '#', ' ', '#', ' ', '#', ' ', ' ', ' ', '#', ' ', '#', ' ', ' ', ' ', ' ', ' ', '#', ' ', ' ', ' ', ' ', ' ', '#', ' ', ' ', ' ', '#', ' ', ' ', ' ', ' ', ' ', ' ', ' ', '#', ' ', '#', ' ', ' ', ' ', '#', ' ', '#', ' ', '#', ' ', '#', ' ', ' ', ' ', '#'},
{'#', ' ', '#', '#', '#', ' ', '#', ' ', '#', ' ', '#', '#', '#', ' ', '#', '#', '#', ' ', '#', ' ', '#', '#', '#', '#', '#', '#', '#', ' ', '#', ' ', '#', '#', '#', '#', '#', '#', '#', ' ', '#', '#', '#', '#', '#', '#', '#', '#', '#', '#', '#', ' ', '#', '#', '#', ' ', '#', ' ', '#', '#', '#', ' ', '#', ' ', '#', '#', '#', ' ', '#', '#', '#', '#', '#', ' ', '#', '#', '#', '#', '#', ' ', '#', '#', '#', '#', '#', '#', '#', ' ', '#', ' ', '#', '#', '#', ' ', '#', ' ', '#', '#', '#', '#', '#', ' ', '#'},
{'#', ' ', ' ', ' ', '#', ' ', ' ', ' ', '#', ' ', '#', ' ', ' ', ' ', ' ', ' ', ' ', ' ', '#', ' ', '#', ' ', ' ', ' ', ' ', ' ', '#', ' ', '#', ' ', ' ', ' ', ' ', ' ', ' ', ' ', '#', ' ', ' ', ' ', ' ', ' ', ' ', ' ', ' ', ' ', ' ', ' ', ' ', ' ', ' ', ' ', ' ', ' ', '#', ' ', '#', ' ', ' ', ' ', '#', ' ', ' ', ' ', '#', ' ', ' ', ' ', ' ', ' ', '#', ' ', ' ', ' ', ' ', ' ', ' ', ' ', '#', ' ', ' ', ' ', ' ', ' ', ' ', ' ', ' ', ' ', '#', ' ', ' ', ' ', '#', ' ', ' ', ' ', ' ', ' ', '#', ' ', '#'},
{'#', ' ', '#', ' ', '#', '#', '#', ' ', '#', ' ', '#', '#', '#', ' ', '#', '#', '#', '#', '#', ' ', '#', ' ', '#', '#', '#', ' ', '#', ' ', '#', ' ', '#', '#', '#', '#', '#', '#', '#', '#', '#', ' ', '#', '#', '#', ' ', '#', '#', '#', '#', '#', '#', '#', '#', '#', ' ', '#', ' ', '#', '#', '#', ' ', '#', ' ', '#', ' ', '#', '#', '#', '#', '#', ' ', '#', ' ', '#', '#', '#', '#', '#', ' ', '#', '#', '#', '#', '#', '#', '#', '#', '#', ' ', '#', '#', '#', '#', '#', ' ', '#', '#', '#', '#', '#', ' ', '#'},
{'#', ' ', '#', ' ', ' ', ' ', '#', ' ', '#', ' ', '#', ' ', '#', ' ', '#', ' ', ' ', ' ', ' ', ' ', '#', ' ', '#', ' ', '#', ' ', '#', ' ', '#', ' ', '#', ' ', ' ', ' ', ' ', ' ', ' ', ' ', ' ', ' ', ' ', ' ', ' ', ' ', '#', ' ', ' ', ' ', ' ', ' ', ' ', ' ', '#', ' ', '#', ' ', ' ', ' ', '#', ' ', '#', ' ', ' ', ' ', ' ', ' ', ' ', ' ', '#', ' ', ' ', ' ', '#', ' ', ' ', ' ', '#', ' ', '#', ' ', ' ', ' ', ' ', ' ', ' ', ' ', '#', ' ', '#', ' ', ' ', ' ', ' ', ' ', '#', ' ', ' ', ' ', ' ', ' ', '#'},
{'#', ' ', '#', '#', '#', '#', '#', ' ', '#', '#', '#', ' ', '#', ' ', '#', '#', '#', '#', '#', ' ', '#', ' ', '#', ' ', '#', ' ', '#', ' ', '#', '#', '#', '#', '#', '#', '#', ' ', '#', '#', '#', '#', '#', '#', '#', '#', '#', ' ', '#', '#', '#', '#', '#', ' ', '#', '#', '#', ' ', '#', '#', '#', '#', '#', ' ', '#', '#', '#', '#', '#', ' ', '#', ' ', '#', '#', '#', ' ', '#', '#', '#', ' ', '#', ' ', '#', '#', '#', ' ', '#', '#', '#', ' ', '#', ' ', '#', '#', '#', '#', '#', ' ', '#', '#', '#', ' ', '#'},
{'#', ' ', ' ', ' ', ' ', ' ', ' ', ' ', '#', ' ', ' ', ' ', ' ', ' ', ' ', ' ', ' ', ' ', '#', ' ', '#', ' ', '#', ' ', '#', ' ', '#', ' ', ' ', ' ', ' ', ' ', ' ', ' ', '#', ' ', ' ', ' ', '#', ' ', ' ', ' ', ' ', ' ', ' ', ' ', '#', ' ', ' ', ' ', '#', ' ', ' ', ' ', ' ', ' ', '#', ' ', ' ', ' ', '#', ' ', '#', ' ', ' ', ' ', '#', ' ', '#', ' ', '#', ' ', ' ', ' ', '#', ' ', ' ', ' ', '#', ' ', '#', ' ', '#', ' ', '#', ' ', ' ', ' ', '#', ' ', '#', ' ', '#', ' ', ' ', ' ', '#', ' ', '#', ' ', '#'},
{'#', ' ', '#', '#', '#', '#', '#', ' ', '#', '#', '#', '#', '#', '#', '#', '#', '#', ' ', '#', '#', '#', ' ', '#', ' ', '#', ' ', '#', '#', '#', '#', '#', '#', '#', ' ', '#', '#', '#', '#', '#', ' ', '#', '#', '#', ' ', '#', ' ', '#', '#', '#', ' ', '#', '#', '#', '#', '#', ' ', '#', '#', '#', ' ', '#', '#', '#', ' ', '#', '#', '#', ' ', '#', '#', '#', '#', '#', ' ', '#', '#', '#', '#', '#', ' ', '#', ' ', '#', '#', '#', ' ', '#', '#', '#', ' ', '#', ' ', '#', ' ', '#', '#', '#', ' ', '#', ' ', '#'},
{'#', ' ', ' ', ' ', ' ', ' ', '#', ' ', ' ', ' ', ' ', ' ', ' ', ' ', ' ', ' ', ' ', ' ', ' ', ' ', ' ', ' ', ' ', ' ', ' ', ' ', ' ', ' ', ' ', ' ', ' ', ' ', ' ', ' ', ' ', ' ', ' ', ' ', ' ', ' ', ' ', ' ', ' ', ' ', '#', ' ', ' ', ' ', ' ', ' ', ' ', ' ', ' ', ' ', ' ', ' ', ' ', ' ', ' ', ' ', ' ', ' ', ' ', ' ', ' ', ' ', ' ', ' ', ' ', ' ', ' ', ' ', ' ', ' ', ' ', ' ', ' ', ' ', ' ', ' ', ' ', ' ', ' ', ' ', ' ', ' ', ' ', ' ', ' ', ' ', ' ', ' ', '#', ' ', ' ', ' ', ' ', ' ', ' ', ' ', ' '},
{'#', '#', '#', '#', '#', '#', '#', '#', '#', '#', '#', '#', '#', '#', '#', '#', '#', '#', '#', '#', '#', '#', '#', '#', '#', '#', '#', '#', '#', '#', '#', '#', '#', '#', '#', '#', '#', '#', '#', '#', '#', '#', '#', '#', '#', '#', '#', '#', '#', '#', '#', '#', '#', '#', '#', '#', '#', '#', '#', '#', '#', '#', '#', '#', '#', '#', '#', '#', '#', '#', '#', '#', '#', '#', '#', '#', '#', '#', '#', '#', '#', '#', '#', '#', '#', '#', '#', '#', '#', '#', '#', '#', '#', '#', '#', '#', '#', '#', '#', '#', '#'}
}