{
{' ', '#', '#', '#', '#', '#', '#', '#', '#', '#', '#', '#', '#', '#', '#', '#', '#', '#', '#', '#', '#', '#', '#', '#', '#', '#', '#', '#', '#', '#', '#', '#', '#', '#', '#', '#', '#', '#', '#', '#', '#', '#', '#', '#', '#', '#', '#', '#', '#', '#', '#', '#', '#', '#', '#', '#', '#', '#', '#', '#', '#', '#', '#', '#', '#', '#', '#', '#', '#', '#', '#', '#', '#', '#', '#', '#', '#', '#', '#', '#', '#', '#', '#', '#', '#', '#', '#', '#', '#', '#', '#', '#', '#', '#', '#', '#', '#', '#', '#', '#', '#'},
{' ', ' ', ' ', ' ', ' ', ' ', ' ', ' ', ' ', ' ', ' ', ' ', ' ', ' ', ' ', ' ', ' ', ' ', ' ', ' ', ' ', ' ', ' ', ' ', ' ', ' ', ' ', ' ', ' ', ' ', ' ', ' ', ' ', ' ', ' ', ' ', ' ', ' ', ' ', ' ', ' ', ' ', ' ', ' ', ' ', ' ', ' ', ' ', ' ', ' ', ' ', ' ', ' ', ' ', ' ', ' ', ' ', ' ', ' ', ' ', ' ', ' ', ' ', ' ', ' ', ' ', ' ', ' ', '#', ' ', ' ', ' ', '#', ' ', ' ', ' ', ' ', ' ', ' ', ' ', ' ', ' ', ' ', ' ', ' ', ' ', ' ', ' ', ' ', ' ', ' ', ' ', ' ', ' ', ' ', ' ', ' ', ' ', ' ', ' ', '#'},
{'#', ' ', '#', '#', '#', '#', '#', ' ', '#', '#', '#', ' ', '#', ' ', '#', '#', '#', '#', '#', ' ', '#', '#', '#', '#', '#', ' ', '#', '#', '#', ' ', '#', '#', '#', ' ', '#', '#', '#', '#', '#', '#', '#', ' ', '#', '#', '#', ' ', '#', '#', '#', ' ', '#', '#', '#', '#', '#', '#', '#', ' ', '#', '#', '#', ' ', '#', '#', '#', '#', '#', ' ', '#', '#', '#', ' ', '#', '#', '#', ' ', '#', '#', '#', ' ', '#', '#', '#', ' ', '#', '#', '#', '#', '#', '#', '#', ' ', '#', '#', '#', ' ', '#', '#', '#', ' ', '#'},
{'#', ' ', '#', ' ', ' ', ' ', '#', ' ', '#', ' ', '#', ' ', '#', ' ', '#', ' ', ' ', ' ', '#', ' ', '#', ' ', ' ', ' ', '#', ' ', '#', ' ', '#', ' ', '#', ' ', '#', ' ', '#', ' ', ' ', ' ', ' ', ' ', '#', ' ', '#', ' ', '#', ' ', '#', ' ', '#', ' ', '#', ' ', ' ', ' ', ' ', ' ', '#', ' ', '#', ' ', '#', ' ', '#', ' ', ' ', ' ', '#', ' ', ' ', ' ', ' ', ' ', ' ', ' ', '#', ' ', '#', ' ', ' ', ' ', '#', ' ', '#', ' ', '#', ' ', ' ', ' ', '#', ' ', ' ', ' ', '#', ' ', '#', ' ', '#', ' ', ' ', ' ', '#'},
{'#', ' ', '#', ' ', '#', '#', '#', ' ', '#', ' ', '#', '#', '#', ' ', '#', '#', '#', ' ', '#', ' ', '#', '#', '#', ' ', '#', ' ', '#', ' ', '#', '#', '#', ' ', '#', ' ', '#', ' ', '#', '#', '#', ' ', '#', ' ', '#', ' ', '#', '#', '#', ' ', '#', ' ', '#', '#', '#', '#', '#', ' ', '#', ' ', '#', ' ', '#', ' ', '#', '#', '#', ' ', '#', '#', '#', '#', '#', '#', '#', ' ', '#', ' ', '#', ' ', '#', '#', '#', ' ', '#', '#', '#', ' ', '#', ' ', '#', '#', '#', '#', '#', ' ', '#', ' ', '#', '#', '#', ' ', '#'},
{'#', ' ', '#', ' ', '#', ' ', ' ', ' ', '#', ' ', ' ', ' ', '#', ' ', ' ', ' ', '#', ' ', '#', ' ', ' ', ' ', ' ', ' ', '#', ' ', '#', ' ', ' ', ' ', ' ', ' ', ' ', ' ', '#', ' ', '#', ' ', '#', ' ', '#', ' ', ' ', ' ', ' ', ' ', ' ', ' ', '#', ' ', '#', ' ', ' ', ' ', '#', ' ', ' ', ' ', '#', ' ', '#', ' ', ' ', ' ', '#', ' ', ' ', ' ', ' ', ' ', ' ', ' ', '#', ' ', ' ', ' ', '#', ' ', '#', ' ', ' ', ' ', ' ', ' ', ' ', ' ', '#', ' ', ' ', ' ', ' ', ' ', ' ', ' ', '#', ' ', ' ', ' ', '#', ' ', '#'},
{'#', '#', '#', ' ', '#', ' ', '#', '#', '#', ' ', '#', '#', '#', ' ', '#', '#', '#', ' ', '#', ' ', '#', '#', '#', '#', '#', '#', '#', '#', '#', '#', '#', ' ', '#', '#', '#', ' ', '#', ' ', '#', ' ', '#', '#', '#', '#', '#', ' ', '#', '#', '#', ' ', '#', ' ', '#', ' ', '#', '#', '#', ' ', '#', ' ', '#', '#', '#', ' ', '#', ' ', '#', ' ', '#', ' ', '#', ' ', '#', ' ', '#', '#', '#', ' ', '#', '#', '#', ' ', '#', '#', '#', ' ', '#', '#', '#', '#', '#', '#', '#', '#', '#', ' ', '#', ' ', '#', ' ', '#'},
{'#', ' ', ' ', ' ', '#', ' ', '#', ' ', ' ', ' ', '#', ' ', ' ', ' ', ' ', ' ', ' ', ' ', '#', ' ', ' ', ' ', ' ', ' ', ' ', ' ', ' ', ' ', ' ', ' ', ' ', ' ', '#', ' ', ' ', ' ', '#', ' ', '#', ' ', ' ', ' ', ' ', ' ', '#', ' ', '#', ' ', ' ', ' ', '#', ' ', '#', ' ', ' ', ' ', '#', ' ', ' ', ' ', ' ', ' ', '#', ' ', '#', ' ', '#', ' ', '#', ' ', '#', ' ', '#', ' ', '#', ' ', ' ', ' ', ' ', ' ', '#', ' ', ' ', ' ', ' ', ' ', ' ', ' ', ' ', ' ', ' ', ' ', ' ', ' ', ' ', ' ', '#', ' ', '#', ' ', '#'},
{'#', ' ', '#', '#', '#', ' ', '#', '#', '#', ' ', '#', '#', '#', '#', '#', '#', '#', '#', '#', ' ', '#', '#', '#', ' ', '#', '#', '#', ' ', '#', '#', '#', '#', '#', ' ', '#', ' ', '#', ' ', '#', '#', '#', '#', '#', ' ', '#', ' ', '#', ' ', '#', '#', '#', ' ', '#', '#', '#', ' ', '#', '#', '#', '#', '#', ' ', '#', '#', '#', '#', '#', ' ', '#', ' ', '#', ' ', '#', ' ', '#', '#', '#', '#', '#', '#', '#', '#', '#', ' ', '#', '#', '#', '#', '#', ' ', '#', '#', '#', ' ', '#', ' ', '#', ' ', '#', ' ', '#'},
{'#', ' ', ' ', ' ', ' ', ' ', '#', ' ', ' ', ' ', ' ', ' ', ' ', ' ', ' ', ' ', ' ', ' ', ' ', ' ', ' ', ' ', ' ', ' ', '#', ' ', '#', ' ', '#', ' ', ' ', ' ', ' ', ' ', '#', ' ', '#', ' ', ' ', ' ', ' ', ' ', '#', ' ', '#', ' ', ' ', ' ', '#', ' ', ' ', ' ', ' ', ' ', '#', ' ', ' ', ' ', ' ', ' ', '#', ' ', ' ', ' ', ' ', ' ', '#', ' ', '#', ' ', '#', ' ', '#', ' ', ' ', ' ', ' ', ' ', ' ', ' ', ' ', ' ', '#', ' ', '#', ' ', '#', ' ', '#', ' ', '#', ' ', '#', ' ', ' ', ' ', '#', ' ', '#', ' ', '#'},
{'#', ' ', '#', '#', '#', '#', '#', ' ', '#', '#', '#', '#', '#', ' ', '#', '#', '#', ' ', '#', '#', '#', '#', '#', '#', '#', ' ', '#', ' ', '#', '#', '#', ' ', '#', '#', '#', ' ', '#', ' ', '#', '#', '#', '#', '#', ' ', '#', '#', '#', '#', '#', ' ', '#', '#', '#', ' ', '#', '#', '#', ' ', '#', '#', '#', ' ', '#', ' ', '#', '#', '#', ' ', '#', '#', '#', ' ', '#', ' ', '#', ' ', '#', '#', '#', '#', '#', ' ', '#', '#', '#', ' ', '#', ' ', '#', ' ', '#', ' ', '#', '#', '#', ' ', '#', ' ', '#', ' ', '#'},
{'#', ' ', ' ', ' ', ' ', ' ', ' ', ' ', ' ', ' ', ' ', ' ', '#', ' ', '#', ' ', ' ', ' ', '#', ' ', ' ', ' ', ' ', ' ', ' ', ' ', '#', ' ', '#', ' ', '#', ' ', '#', ' ', ' ', ' ', '#', ' ', '#', ' ', ' ', ' ', ' ', ' ', ' ', ' ', ' ', ' ', ' ', ' ', ' ', ' ', '#', ' ', ' ', ' ', '#', ' ', '#', ' ', ' ', ' ', '#', ' ', '#', ' ', ' ', ' ', ' ', ' ', ' ', ' ', '#', ' ', '#', ' ', '#', ' ', '#', ' ', '#', ' ', ' ', ' ', ' ', ' ', ' ', ' ', ' ', ' ', ' ', ' ', ' ', ' ', '#', ' ', '#', ' ', '#', ' ', '#'},
{'#', ' ', '#', '#', '#', '#', '#', ' ', '#', '#', '#', ' ', '#', '#', '#', '#', '#', ' ', '#', '#', '#', ' ', '#', '#', '#', '#', '#', ' ', '#', ' ', '#', ' ', '#', '#', '#', '#', '#', ' ', '#', '#', '#', ' ', '#', '#', '#', '#', '#', '#', '#', '#', '#', '#', '#', ' ', '#', '#', '#', ' ', '#', '#', '#', ' ', '#', ' ', '#', ' ', '#', '#', '#', '#', '#', ' ', '#', ' ', '#', '#', '#', ' ', '#', ' ', '#', ' ', '#', '#', '#', '#', '#', '#', '#', '#', '#', ' ', '#', '#', '#', '#', '#', ' ', '#', ' ', '#'},
{'#', ' ', '#', ' ', ' ', ' ', '#', ' ', '#', ' ', '#', ' ', ' ', ' ', ' ', ' ', '#', ' ', ' ', ' ', '#', ' ', '#', ' ', ' ', ' ', ' ', ' ', '#', ' ', '#', ' ', ' ', ' ', ' ', ' ', ' ', ' ', ' ', ' ', '#', ' ', '#', ' ', ' ', ' ', ' ', ' ', '#', ' ', ' ', ' ', ' ', ' ', '#', ' ', ' ', ' ', ' ', ' ', '#', ' ', ' ', ' ', '#', ' ', ' ', ' ', ' ', ' ', '#', ' ', '#', ' ', '#', ' ', ' ', ' ', '#', ' ', '#', ' ', '#', ' ', ' ', ' ', ' ', ' ', ' ', ' ', ' ', ' ', '#', ' ', ' ', ' ', ' ', ' ', '#', ' ', '#'},
{'#', ' ', '#', '#', '#', ' ', '#', '#', '#', ' ', '#', '#', '#', '#', '#', '#', '#', ' ', '#', ' ', '#', ' ', '#', ' ', '#', ' ', '#', '#', '#', ' ', '#', '#', '#', ' ', '#', '#', '#', '#', '#', '#', '#', ' ', '#', '#', '#', '#', '#', ' ', '#', ' ', '#', '#', '#', '#', '#', ' ', '#', '#', '#', ' ', '#', '#', '#', '#', '#', ' ', '#', '#', '#', ' ', '#', '#', '#', '#', '#', ' ', '#', ' ', '#', ' ', '#', ' ', '#', '#', '#', ' ', '#', '#', '#', '#', '#', ' ', '#', '#', '#', ' ', '#', '#', '#', ' ', '#'},
{'#', ' ', ' ', ' ', '#', ' ', ' ', ' ', '#', ' ', ' ', ' ', ' ', ' ', ' ', ' ', ' ', ' ', '#', ' ', '#', ' ', '#', ' ', '#', ' ', '#', ' ', '#', ' ', ' ', ' ', ' ', ' ', '#', ' ', ' ', ' ', ' ', ' ', ' ', ' ', '#', ' ', ' ', ' ', '#', ' ', ' ', ' ', '#', ' ', ' ', ' ', ' ', ' ', '#', ' ', ' ', ' ', ' ', ' ', ' ', ' ', ' ', ' ', '#', ' ', '#', ' ', ' ', ' ', ' ', ' ', ' ', ' ', '#', ' ', '#', ' ', ' ', ' ', ' ', ' ', ' ', ' ', '#', ' ', ' ', ' ', '#', ' ', '#', ' ', ' ', ' ', '#', ' ', ' ', ' ', '#'},
{'#', ' ', '#', ' ', '#', '#', '#', ' ', '#', '#', '#', '#', '#', '#', '#', '#', '#', ' ', '#', ' ', '#', ' ', '#', '#', '#', ' ', '#', ' ', '#', '#', '#', ' ', '#', '#', '#', ' ', '#', '#', '#', '#', '#', ' ', '#', '#', '#', ' ', '#', '#', '#', '#', '#', ' ', '#', '#', '#', '#', '#', '#', '#', ' ', '#', '#', '#', '#', '#', '#', '#', ' ', '#', '#', '#', '#', '#', '#', '#', ' ', '#', '#', '#', ' ', '#', '#', '#', '#', '#', '#', '#', ' ', '#', '#', '#', ' ', '#', '#', '#', ' ', '#', '#', '#', ' ', '#'},
{'#', ' ', '#', ' ', ' ', ' ', '#', ' ', ' ', ' ', '#', ' ', ' ', ' ', ' ', ' ', '#', ' ', '#', ' ', '#', ' ', ' ', ' ', ' ', ' ', '#', ' ', ' ', ' ', '#', ' ', '#', ' ', ' ', ' ', '#', ' ', ' ', ' ', '#', ' ', '#', ' ', '#', ' ', ' ', ' ', ' ', ' ', ' ', ' ', ' ', ' ', ' ', ' ', ' ', ' ', '#', ' ', ' ', ' ', ' ', ' ', ' ', ' ', ' ', ' ', ' ', ' ', ' ', ' ', '#', ' ', ' ', ' ', ' ', ' ', ' ', ' ', '#', ' ', ' ', ' ', ' ', ' ', ' ', ' ', '#', ' ', ' ', ' ', ' ', ' ', '#', ' ', ' ', ' ', '#', ' ', '#'},
{'#', ' ', '#', '#', '#', '#', '#', ' ', '#', '#', '#', ' ', '#', '#', '#', '#', '#', ' ', '#', '#', '#', '#', '#', '#', '#', ' ', '#', ' ', '#', '#', '#', ' ', '#', ' ', '#', ' ', '#', ' ', '#', '#', '#', '#', '#', ' ', '#', ' ', '#', '#', '#', ' ', '#', '#', '#', ' ', '#', '#', '#', ' ', '#', '#', '#', '#', '#', '#', '#', ' ', '#', '#', '#', '#', '#', ' ', '#', '#', '#', '#', '#', '#', '#', '#', '#', ' ', '#', ' ', '#', '#', '#', ' ', '#', '#', '#', ' ', '#', ' ', '#', '#', '#', '#', '#', ' ', '#'},
{'#', ' ', ' ', ' ', ' ', ' ', ' ', ' ', '#', ' ', ' ', ' ', '#', ' ', ' ', ' ', ' ', ' ', ' ', ' ', '#', ' ', ' ', ' ', ' ', ' ', '#', ' ', '#', ' ', ' ', ' ', '#', ' ', '#', ' ', ' ', ' ', '#', ' ', ' ', ' ', ' ', ' ', ' ', ' ', '#', ' ', ' ', ' ', '#', ' ', '#', ' ', '#', ' ', ' ', ' ', ' ', ' ', ' ', ' ', ' ', ' ', '#', ' ', ' ', ' ', ' ', ' ', ' ', ' ', ' ', ' ', ' ', ' ', ' ', ' ', ' ', ' ', ' ', ' ', '#', ' ', ' ', ' ', '#', ' ', ' ', ' ', '#', ' ', '#', ' ', ' ', ' ', ' ', ' ', ' ', ' ', '#'},
{'#', ' ', '#', '#', '#', '#', '#', ' ', '#', '#', '#', ' ', '#', '#', '#', ' ', '#', '#', '#', ' ', '#', '#', '#', '#', '#', '#', '#', ' ', '#', '#', '#', '#', '#', ' ', '#', ' ', '#', ' ', '#', ' ', '#', '#', '#', '#', '#', '#', '#', ' ', '#', '#', '#', ' ', '#', ' ', '#', '#', '#', '#', '#', '#', '#', '#', '#', ' ', '#', '#', '#', ' ', '#', ' ', '#', '#', '#', ' ', '#', '#', '#', ' ', '#', '#', '#', ' ', '#', '#', '#', ' ', '#', '#', '#', ' ', '#', ' ', '#', '#', '#', '#', '#', '#', '#', ' ', '#'},
{'#', ' ', '#', ' ', ' ', ' ', '#', ' ', '#', ' ', '#', ' ', ' ', ' ', ' ', ' ', '#', ' ', '#', ' ', ' ', ' ', ' ', ' ', ' ', ' ', ' ', ' ', ' ', ' ', ' ', ' ', ' ', ' ', '#', ' ', '#', ' ', '#', ' ', '#', ' ', ' ', ' ', ' ', ' ', ' ', ' ', '#', ' ', ' ', ' ', '#', ' ', ' ', ' ', ' ', ' ', ' ', ' ', ' ', ' ', '#', ' ', ' ', ' ', '#', ' ', '#', ' ', '#', ' ', '#', ' ', ' ', ' ', '#', ' ', '#', ' ', ' ', ' ', ' ', ' ', '#', ' ', ' ', ' ', '#', ' ', '#', ' ', ' ', ' ', '#', ' ', ' ', ' ', '#', ' ', '#'},
{'#', ' ', '#', '#', '#', ' ', '#', '#', '#', ' ', '#', '#', '#', '#', '#', '#', '#', ' ', '#', '#', '#', '#', '#', '#', '#', '#', '#', '#', '#', '#', '#', '#', '#', '#', '#', ' ', '#', '#', '#', ' ', '#', '#', '#', '#', '#', ' ', '#', '#', '#', '#', '#', ' ', '#', '#', '#', ' ', '#', '#', '#', '#', '#', ' ', '#', '#', '#', '#', '#', ' ', '#', '#', '#', ' ', '#', '#', '#', '#', '#', ' ', '#', '#', '#', '#', '#', ' ', '#', '#', '#', '#', '#', ' ', '#', '#', '#', '#', '#', ' ', '#', '#', '#', ' ', '#'},
{'#', ' ', ' ', ' ', ' ', ' ', ' ', ' ', ' ', ' ', ' ', ' ', ' ', ' ', ' ', ' ', ' ', ' ', ' ', ' ', ' ', ' ', ' ', ' ', ' ', ' ', ' ', ' ', ' ', ' ', ' ', ' ', ' ', ' ', ' ', ' ', ' ', ' ', ' ', ' ', ' ', ' ', ' ', ' ', '#', ' ', ' ', ' ', ' ', ' ', ' ', ' ', ' ', ' ', ' ', ' ', '#', ' ', ' ', ' ', ' ', ' ', ' ', ' ', ' ', ' ', ' ', ' ', ' ', ' ', ' ', ' ', ' ', ' ', ' ', ' ', ' ', ' ', ' ', ' ', ' ', ' ', ' ', ' ', ' ', ' ', ' ', ' ', ' ', ' ', ' ', ' ', ' ', ' ', ' ', ' ', ' ', ' ', ' ', ' ', ' '},
{'#', '#', '#', '#', '#', '#', '#', '#', '#', '#', '#', '#', '#', '#', '#', '#', '#', '#', '#', '#', '#', '#', '#', '#', '#', '#', '#', '#', '#', '#', '#', '#', '#', '#', '#', '#', '#', '#', '#', '#', '#', '#', '#', '#', '#', '#', '#', '#', '#', '#', '#', '#', '#', '#', '#', '#', '#', '#', '#', '#', '#', '#', '#', '#', '#', '#', '#', '#', '#', '#', '#', '#', '#', '#', '#', '#', '#', '#', '#', '#', '#', '#', '#', '#', '#', '#', '#', '#', '#', '#', '#', '#', '#', '#', '#', '#', '#', '#', '#', '#', '#'}
}
