{
{' ', '#', '#', '#', '#', '#', '#', '#', '#', '#', '#', '#', '#', '#', '#', '#', '#', '#', '#', '#', '#', '#', '#', '#', '#', '#', '#', '#', '#', '#', '#', '#', '#', '#', '#', '#', '#', '#', '#', '#', '#', '#', '#', '#', '#', '#', '#', '#', '#', '#', '#', '#', '#', '#', '#', '#', '#', '#', '#', '#', '#', '#', '#', '#', '#', '#', '#', '#', '#', '#', '#', '#', '#', '#', '#', '#', '#', '#', '#', '#', '#', '#', '#', '#', '#', '#', '#', '#', '#', '#', '#', '#', '#', '#', '#', '#', '#', '#', '#', '#', '#'},
{' ', ' ', ' ', ' ', ' ', ' ', ' ', ' ', ' ', ' ', ' ', ' ', ' ', ' ', ' ', ' ', '#', ' ', ' ', ' ', ' ', ' ', ' ', ' ', ' ', ' ', ' ', ' ', ' ', ' ', ' ', ' ', ' ', ' ', ' ', ' ', ' ', ' ', ' ', ' ', ' ', ' ', ' ', ' ', ' ', ' ', ' ', ' ', ' ', ' ', ' ', ' ', ' ', ' ', ' ', ' ', ' ', ' ', ' ', ' ', ' ', ' ', ' ', ' ', ' ', ' ', ' ', ' ', ' ', ' ', ' ', ' ', ' ', ' ', ' ', ' ', ' ', ' ', ' ', ' ', ' ', ' ', ' ', ' ', ' ', ' ', ' ', ' ', ' ', ' ', ' ', ' ', ' ', ' ', '#', ' ', ' ', ' ', ' ', ' ', '#'},
{'#', ' ', '#', '#', '#', '#', '#', '#', '#', '#', '#', '#', '#', '#', '#', ' ', '#', '#', '#', ' ', '#', '#', '#', ' ', '#', '#', '#', '#', '#', '#', '#', ' ', '#', '#', '#', '#', '#', ' ', '#', '#', '#', ' ', '#', '#', '#', ' ', '#', '#', '#', '#', '#', '#', '#', '#', '#', '#', '#', '#', '#', '#', '#', ' ', '#', '#', '#', '#', '#', ' ', '#', '#', '#', ' ', '#', '#', '#', ' ', '#', '#', '#', '#', '#', '#', '#', ' ', '#', '#', '#', '#', '#', ' ', '#', '#', '#', ' ', '#', ' ', '#', '#', '#', ' ', '#'},
{'#', ' ', '#', ' ', ' ', ' ', ' ', ' ', ' ', ' ', ' ', ' ', ' ', ' ', '#', ' ', ' ', ' ', '#', ' ', '#', ' ', '#', ' ', ' ', ' ', ' ', ' ', ' ', ' ', '#', ' ', '#', ' ', ' ', ' ', ' ', ' ', '#', ' ', '#', ' ', ' ', ' ', ' ', ' ', '#', ' ', ' ', ' ', ' ', ' ', ' ', ' ', ' ', ' ', ' ', ' ', ' ', ' ', '#', ' ', ' ', ' ', ' ', ' ', '#', ' ', '#', ' ', '#', ' ', '#', ' ', '#', ' ', ' ', ' ', ' ', ' ', ' ', ' ', ' ', ' ', '#', ' ', ' ', ' ', '#', ' ', '#', ' ', '#', ' ', '#', ' ', '#', ' ', '#', ' ', '#'},
{'#', ' ', '#', '#', '#', ' ', '#', '#', '#', '#', '#', '#', '#', ' ', '#', '#', '#', ' ', '#', ' ', '#', ' ', '#', '#', '#', '#', '#', '#', '#', '#', '#', '#', '#', ' ', '#', '#', '#', ' ', '#', ' ', '#', ' ', '#', '#', '#', '#', '#', ' ', '#', '#', '#', ' ', '#', '#', '#', ' ', '#', '#', '#', ' ', '#', '#', '#', '#', '#', '#', '#', ' ', '#', ' ', '#', '#', '#', ' ', '#', '#', '#', '#', '#', '#', '#', '#', '#', '#', '#', ' ', '#', '#', '#', ' ', '#', ' ', '#', ' ', '#', ' ', '#', ' ', '#', ' ', '#'},
{'#', ' ', ' ', ' ', ' ', ' ', '#', ' ', ' ', ' ', ' ', ' ', '#', ' ', ' ', ' ', '#', ' ', '#', ' ', '#', ' ', ' ', ' ', '#', ' ', ' ', ' ', ' ', ' ', ' ', ' ', ' ', ' ', '#', ' ', '#', ' ', '#', ' ', '#', ' ', '#', ' ', ' ', ' ', ' ', ' ', ' ', ' ', '#', ' ', '#', ' ', '#', ' ', '#', ' ', '#', ' ', '#', ' ', '#', ' ', ' ', ' ', ' ', ' ', '#', ' ', ' ', ' ', ' ', ' ', ' ', ' ', ' ', ' ', '#', ' ', ' ', ' ', ' ', ' ', ' ', ' ', '#', ' ', ' ', ' ', '#', ' ', '#', ' ', '#', ' ', '#', ' ', ' ', ' ', '#'},
{'#', ' ', '#', ' ', '#', '#', '#', ' ', '#', '#', '#', ' ', '#', '#', '#', ' ', '#', ' ', '#', ' ', '#', ' ', '#', '#', '#', ' ', '#', '#', '#', '#', '#', '#', '#', ' ', '#', ' ', '#', '#', '#', ' ', '#', '#', '#', ' ', '#', '#', '#', ' ', '#', '#', '#', ' ', '#', ' ', '#', ' ', '#', ' ', '#', ' ', '#', ' ', '#', '#', '#', ' ', '#', '#', '#', ' ', '#', ' ', '#', '#', '#', '#', '#', ' ', '#', '#', '#', '#', '#', '#', '#', ' ', '#', '#', '#', ' ', '#', ' ', '#', '#', '#', ' ', '#', '#', '#', ' ', '#'},
{'#', ' ', '#', ' ', '#', ' ', ' ', ' ', '#', ' ', ' ', ' ', ' ', ' ', '#', ' ', '#', ' ', '#', ' ', '#', ' ', '#', ' ', ' ', ' ', ' ', ' ', '#', ' ', ' ', ' ', ' ', ' ', '#', ' ', ' ', ' ', ' ', ' ', ' ', ' ', ' ', ' ', ' ', ' ', ' ', ' ', '#', ' ', ' ', ' ', ' ', ' ', '#', ' ', '#', ' ', '#', ' ', ' ', ' ', ' ', ' ', '#', ' ', '#', ' ', ' ', ' ', '#', ' ', '#', ' ', ' ', ' ', '#', ' ', ' ', ' ', ' ', ' ', ' ', ' ', ' ', ' ', ' ', ' ', '#', ' ', ' ', ' ', ' ', ' ', ' ', ' ', ' ', ' ', '#', ' ', '#'},
{'#', ' ', '#', ' ', '#', ' ', '#', '#', '#', ' ', '#', '#', '#', ' ', '#', '#', '#', ' ', '#', ' ', '#', ' ', '#', ' ', '#', '#', '#', ' ', '#', ' ', '#', '#', '#', '#', '#', ' ', '#', '#', '#', ' ', '#', '#', '#', ' ', '#', '#', '#', '#', '#', ' ', '#', ' ', '#', '#', '#', ' ', '#', ' ', '#', '#', '#', '#', '#', ' ', '#', '#', '#', ' ', '#', '#', '#', ' ', '#', ' ', '#', ' ', '#', '#', '#', ' ', '#', '#', '#', '#', '#', ' ', '#', ' ', '#', '#', '#', ' ', ' ', ' ', '#', '#', '#', ' ', '#', ' ', '#'},
{'#', ' ', ' ', ' ', '#', ' ', ' ', ' ', ' ', ' ', '#', ' ', ' ', ' ', ' ', ' ', ' ', ' ', ' ', ' ', '#', ' ', '#', ' ', '#', ' ', ' ', ' ', ' ', ' ', '#', ' ', ' ', ' ', ' ', ' ', '#', ' ', ' ', ' ', '#', ' ', ' ', ' ', '#', ' ', ' ', ' ', ' ', ' ', ' ', ' ', ' ', ' ', '#', ' ', '#', ' ', ' ', ' ', ' ', ' ', '#', ' ', ' ', ' ', ' ', ' ', '#', ' ', '#', ' ', '#', ' ', '#', ' ', ' ', ' ', '#', ' ', '#', ' ', ' ', ' ', '#', ' ', '#', ' ', ' ', ' ', '#', ' ', ' ', ' ', '#', ' ', '#', ' ', '#', ' ', '#'},
{'#', ' ', '#', '#', '#', ' ', '#', '#', '#', '#', '#', ' ', '#', '#', '#', ' ', '#', '#', '#', '#', '#', ' ', '#', ' ', '#', '#', '#', ' ', '#', '#', '#', ' ', '#', '#', '#', ' ', '#', '#', '#', ' ', '#', ' ', '#', '#', '#', ' ', '#', ' ', '#', ' ', '#', '#', '#', ' ', '#', ' ', '#', ' ', '#', '#', '#', ' ', '#', '#', '#', ' ', '#', '#', '#', ' ', '#', ' ', '#', ' ', '#', '#', '#', ' ', '#', '#', '#', ' ', '#', '#', '#', ' ', '#', '#', '#', ' ', '#', '#', '#', ' ', '#', ' ', '#', '#', '#', ' ', '#'},
{'#', ' ', '#', ' ', '#', ' ', ' ', ' ', ' ', ' ', '#', ' ', '#', ' ', '#', ' ', '#', ' ', ' ', ' ', ' ', ' ', ' ', ' ', ' ', ' ', '#', ' ', '#', ' ', ' ', ' ', '#', ' ', ' ', ' ', ' ', ' ', '#', ' ', '#', ' ', '#', ' ', '#', ' ', '#', ' ', '#', ' ', '#', ' ', '#', ' ', ' ', ' ', '#', ' ', ' ', ' ', ' ', ' ', ' ', ' ', '#', ' ', '#', ' ', ' ', ' ', ' ', ' ', '#', ' ', ' ', ' ', ' ', ' ', ' ', ' ', ' ', ' ', ' ', ' ', '#', ' ', ' ', ' ', '#', ' ', ' ', ' ', '#', ' ', ' ', ' ', '#', ' ', ' ', ' ', '#'},
{'#', ' ', '#', ' ', '#', '#', '#', '#', '#', ' ', '#', '#', '#', ' ', '#', ' ', '#', ' ', '#', '#', '#', '#', '#', ' ', '#', '#', '#', ' ', '#', ' ', '#', '#', '#', '#', '#', '#', '#', '#', '#', ' ', '#', '#', '#', ' ', '#', ' ', '#', ' ', '#', ' ', '#', ' ', '#', '#', '#', '#', '#', ' ', '#', '#', '#', '#', '#', '#', '#', ' ', '#', ' ', '#', '#', '#', ' ', '#', ' ', '#', '#', '#', '#', '#', '#', '#', ' ', '#', '#', '#', ' ', '#', ' ', '#', '#', '#', ' ', '#', '#', '#', ' ', '#', ' ', '#', ' ', '#'},
{'#', ' ', '#', ' ', ' ', ' ', ' ', ' ', '#', ' ', ' ', ' ', ' ', ' ', '#', ' ', '#', ' ', '#', ' ', ' ', ' ', '#', ' ', ' ', ' ', '#', ' ', '#', ' ', '#', ' ', ' ', ' ', ' ', ' ', ' ', ' ', ' ', ' ', ' ', ' ', ' ', ' ', '#', ' ', '#', ' ', '#', ' ', '#', ' ', ' ', ' ', ' ', ' ', ' ', ' ', '#', ' ', ' ', ' ', ' ', ' ', ' ', ' ', '#', ' ', '#', ' ', '#', ' ', '#', ' ', ' ', ' ', ' ', ' ', '#', ' ', ' ', ' ', '#', ' ', ' ', ' ', '#', ' ', ' ', ' ', ' ', ' ', ' ', ' ', '#', ' ', '#', ' ', '#', ' ', '#'},
{'#', ' ', '#', ' ', '#', ' ', '#', '#', '#', ' ', '#', '#', '#', ' ', '#', ' ', '#', ' ', '#', '#', '#', ' ', '#', '#', '#', '#', '#', ' ', '#', ' ', '#', '#', '#', ' ', '#', '#', '#', ' ', '#', '#', '#', '#', '#', '#', '#', ' ', '#', '#', '#', ' ', '#', '#', '#', ' ', '#', '#', '#', ' ', '#', ' ', '#', ' ', '#', '#', '#', '#', '#', ' ', '#', ' ', '#', ' ', '#', '#', '#', '#', '#', ' ', '#', '#', '#', '#', '#', '#', '#', ' ', '#', ' ', '#', ' ', '#', '#', '#', '#', '#', ' ', '#', '#', '#', ' ', '#'},
{'#', ' ', ' ', ' ', '#', ' ', '#', ' ', ' ', ' ', '#', ' ', ' ', ' ', '#', ' ', '#', ' ', ' ', ' ', '#', ' ', ' ', ' ', ' ', ' ', ' ', ' ', '#', ' ', ' ', ' ', ' ', ' ', '#', ' ', '#', ' ', '#', ' ', ' ', ' ', ' ', ' ', ' ', ' ', ' ', ' ', ' ', ' ', ' ', ' ', '#', ' ', ' ', ' ', '#', ' ', '#', ' ', ' ', ' ', '#', ' ', ' ', ' ', ' ', ' ', ' ', ' ', '#', ' ', ' ', ' ', ' ', ' ', '#', ' ', ' ', ' ', ' ', ' ', ' ', ' ', ' ', ' ', '#', ' ', '#', ' ', '#', ' ', ' ', ' ', '#', ' ', ' ', ' ', '#', ' ', '#'},
{'#', ' ', '#', '#', '#', '#', '#', ' ', '#', '#', '#', ' ', '#', '#', '#', ' ', '#', ' ', '#', ' ', '#', '#', '#', ' ', '#', '#', '#', ' ', '#', '#', '#', ' ', '#', ' ', '#', ' ', '#', ' ', '#', '#', '#', ' ', '#', ' ', '#', '#', '#', '#', '#', '#', '#', '#', '#', ' ', '#', '#', '#', ' ', '#', '#', '#', '#', '#', ' ', '#', '#', '#', '#', '#', ' ', '#', '#', '#', ' ', '#', '#', '#', ' ', '#', '#', '#', ' ', '#', '#', '#', '#', '#', ' ', '#', ' ', '#', ' ', '#', '#', '#', ' ', '#', '#', '#', ' ', '#'},
{'#', ' ', ' ', ' ', ' ', ' ', ' ', ' ', '#', ' ', ' ', ' ', '#', ' ', ' ', ' ', '#', ' ', '#', ' ', ' ', ' ', '#', ' ', ' ', ' ', ' ', ' ', ' ', ' ', '#', ' ', ' ', ' ', '#', ' ', '#', ' ', ' ', ' ', '#', ' ', '#', ' ', '#', ' ', ' ', ' ', ' ', ' ', ' ', ' ', ' ', ' ', '#', ' ', ' ', ' ', ' ', ' ', ' ', ' ', ' ', ' ', '#', ' ', ' ', ' ', '#', ' ', ' ', ' ', ' ', ' ', '#', ' ', ' ', ' ', '#', ' ', '#', ' ', '#', ' ', ' ', ' ', ' ', ' ', ' ', ' ', '#', ' ', '#', ' ', ' ', ' ', ' ', ' ', ' ', ' ', '#'},
{'#', ' ', '#', '#', '#', '#', '#', '#', '#', ' ', '#', '#', '#', '#', '#', ' ', '#', ' ', '#', '#', '#', ' ', '#', '#', '#', ' ', '#', '#', '#', ' ', '#', ' ', '#', '#', '#', ' ', '#', '#', '#', '#', '#', ' ', '#', '#', '#', ' ', '#', ' ', '#', '#', '#', '#', '#', ' ', '#', ' ', '#', '#', '#', ' ', '#', '#', '#', ' ', '#', '#', '#', ' ', '#', ' ', '#', ' ', '#', '#', '#', ' ', '#', '#', '#', ' ', '#', ' ', '#', ' ', '#', '#', '#', ' ', '#', '#', '#', ' ', '#', ' ', '#', '#', '#', '#', '#', ' ', '#'},
{'#', ' ', '#', ' ', '#', ' ', ' ', ' ', ' ', ' ', ' ', ' ', ' ', ' ', '#', ' ', '#', ' ', ' ', ' ', '#', ' ', ' ', ' ', '#', ' ', '#', ' ', ' ', ' ', ' ', ' ', '#', ' ', ' ', ' ', ' ', ' ', '#', ' ', ' ', ' ', ' ', ' ', ' ', ' ', '#', ' ', '#', ' ', ' ', ' ', '#', ' ', '#', ' ', ' ', ' ', '#', ' ', '#', ' ', ' ', ' ', ' ', ' ', '#', ' ', '#', ' ', '#', ' ', '#', ' ', ' ', ' ', '#', ' ', ' ', ' ', ' ', ' ', '#', ' ', '#', ' ', '#', ' ', '#', ' ', ' ', ' ', ' ', ' ', '#', ' ', ' ', ' ', '#', ' ', '#'},
{'#', ' ', '#', ' ', '#', ' ', '#', ' ', '#', '#', '#', ' ', '#', '#', '#', ' ', '#', '#', '#', ' ', '#', ' ', '#', '#', '#', ' ', '#', ' ', '#', '#', '#', '#', '#', ' ', '#', '#', '#', '#', '#', ' ', '#', '#', '#', '#', '#', ' ', '#', '#', '#', ' ', '#', ' ', '#', '#', '#', ' ', '#', '#', '#', ' ', '#', '#', '#', '#', '#', '#', '#', ' ', '#', ' ', '#', ' ', '#', '#', '#', ' ', '#', ' ', '#', '#', '#', ' ', '#', '#', '#', ' ', '#', '#', '#', ' ', '#', '#', '#', ' ', '#', ' ', '#', '#', '#', ' ', '#'},
{'#', ' ', '#', ' ', '#', ' ', '#', ' ', '#', ' ', '#', ' ', '#', ' ', ' ', ' ', ' ', ' ', '#', ' ', '#', ' ', '#', ' ', ' ', ' ', '#', ' ', '#', ' ', ' ', ' ', ' ', ' ', '#', ' ', ' ', ' ', ' ', ' ', '#', ' ', ' ', ' ', '#', ' ', ' ', ' ', ' ', ' ', '#', ' ', ' ', ' ', ' ', ' ', '#', ' ', ' ', ' ', ' ', ' ', ' ', ' ', ' ', ' ', ' ', ' ', '#', ' ', '#', ' ', ' ', ' ', '#', ' ', '#', ' ', '#', ' ', '#', ' ', '#', ' ', ' ', ' ', ' ', ' ', ' ', ' ', '#', ' ', '#', ' ', ' ', ' ', '#', ' ', ' ', ' ', '#'},
{'#', ' ', '#', ' ', '#', '#', '#', '#', '#', ' ', '#', '#', '#', ' ', '#', '#', '#', '#', '#', ' ', '#', ' ', '#', '#', '#', ' ', '#', '#', '#', ' ', '#', '#', '#', ' ', '#', '#', '#', '#', '#', '#', '#', ' ', '#', ' ', '#', '#', '#', '#', '#', '#', '#', ' ', '#', '#', '#', '#', '#', ' ', '#', '#', '#', '#', '#', '#', '#', '#', '#', '#', '#', ' ', '#', '#', '#', ' ', '#', '#', '#', '#', '#', ' ', '#', '#', '#', '#', '#', '#', '#', ' ', '#', '#', '#', ' ', '#', '#', '#', '#', '#', ' ', '#', ' ', '#'},
{'#', ' ', ' ', ' ', ' ', ' ', ' ', ' ', ' ', ' ', ' ', ' ', ' ', ' ', ' ', ' ', ' ', ' ', ' ', ' ', ' ', ' ', ' ', ' ', ' ', ' ', ' ', ' ', ' ', ' ', '#', ' ', ' ', ' ', ' ', ' ', ' ', ' ', ' ', ' ', ' ', ' ', '#', ' ', ' ', ' ', ' ', ' ', ' ', ' ', ' ', ' ', ' ', ' ', ' ', ' ', ' ', ' ', ' ', ' ', ' ', ' ', ' ', ' ', ' ', ' ', ' ', ' ', ' ', ' ', ' ', ' ', ' ', ' ', ' ', ' ', ' ', ' ', ' ', ' ', ' ', ' ', ' ', ' ', ' ', ' ', ' ', ' ', ' ', ' ', ' ', ' ', ' ', ' ', ' ', ' ', ' ', ' ', ' ', ' ', ' '},
{'#', '#', '#', '#', '#', '#', '#', '#', '#', '#', '#', '#', '#', '#', '#', '#', '#', '#', '#', '#', '#', '#', '#', '#', '#', '#', '#', '#', '#', '#', '#', '#', '#', '#', '#', '#', '#', '#', '#', '#', '#', '#', '#', '#', '#', '#', '#', '#', '#', '#', '#', '#', '#', '#', '#', '#', '#', '#', '#', '#', '#', '#', '#', '#', '#', '#', '#', '#', '#', '#', '#', '#', '#', '#', '#', '#', '#', '#', '#', '#', '#', '#', '#', '#', '#', '#', '#', '#', '#', '#', '#', '#', '#', '#', '#', '#', '#', '#', '#', '#', '#'}
}